4 4 4 4 4 4 4 4 4 4 4 4 4 4 4 4 3 3 3 3 3 3 21 21 21 21 21 21 21 21 21 22 22 22 22 22 22 23 23 23 
4 4 4 4 4 4 4 4 4 4 4 4 4 4 4 4 3 3 3 3 3 3 21 21 21 21 21 21 21 21 21 22 22 22 22 22 22 23 23 23 
4 4 4 4 4 4 4 4 4 4 4 4 4 4 4 4 3 3 3 3 3 3 21 21 21 21 21 21 21 21 21 22 22 22 22 22 22 23 23 23 
4 4 4 4 4 4 4 4 4 4 4 4 4 4 4 4 3 3 3 3 3 3 21 21 21 21 21 21 21 21 21 22 22 22 22 22 22 23 23 23 
4 4 4 4 4 4 4 4 4 4 4 4 4 4 4 4 3 3 3 3 3 3 21 21 21 21 21 21 21 21 21 22 22 22 22 22 22 23 23 23 
4 4 4 4 4 4 4 4 4 4 4 4 4 4 4 4 3 3 3 3 3 3 21 21 21 21 21 21 21 21 21 22 22 22 22 22 22 23 23 23 
4 4 4 4 4 4 4 4 4 4 4 4 4 4 4 4 3 3 3 3 3 3 19 19 19 19 19 19 19 19 19 19 19 19 19 19 19 19 19 19 
G 4 4 4 4 4 4 4 4 4 4 4 4 4 4 4 3 3 3 3 3 3 19 19 19 19 19 19 19 19 19 19 19 19 19 19 19 19 19 19 
W W W W W W W W W W W W W W W W W W W W W W W W W W W W W W W W 19 19 19 19 19 19 19 19 
W W W W W W W W W W W W W W W W W W W W W W W W W W W W W W W W 19 19 19 19 19 19 19 19 
W W W W W W W W W W W W W W W W W W W W W W W W W W W W W W W W 19 19 19 19 19 19 19 19 
W W W W W W W W W W W W W W W W W W W W W W W W W W W W W W W W 19 19 19 19 19 19 19 19 
W W W W W W W W W W W W W W W W W W W W W W W W W W W W W W W W 20 20 20 20 20 20 20 20 
W W W W W W W W W W W W W W W W W W W W W W W W W W W W W W W W 20 20 20 20 20 20 20 20 
W W W W W W W W W W W W W W W W W W W W W W W W W W W W W W W W 20 20 20 20 20 20 20 20 
W W W W W W W W W W W W W W W W W W W W W W W W W W W W W W W W 20 20 20 20 20 20 20 20 
W W W W W W W W W W W W W W W W W W W W W W W W W W W W W W W W 20 20 20 20 20 20 20 20 
W W W W W W W W W W W W W W W W W W W W W W W W W W W W W W W W 20 20 20 20 20 20 20 20 
W W W W W W W W W W W W W W W W W W W W W W W W W W W W W W W W 20 20 20 20 20 20 20 20 
W W W W W W W W W W W W W W W W W W W W W W W W W W W W W W W W 20 20 20 20 20 20 20 20 
W W W W W W W W W W W W W W W W W W W W W W W W W W W W W W W W 20 20 20 20 20 20 20 20 
W W W W W W W W W W W W W W W W W W W W W W W W W W W W W W W W 20 20 20 20 20 20 20 20 
W W W W W W W W W W W W W W W W W W W W W W W W W W W W W W W W 20 20 20 20 20 20 20 20 
W W W W W W W W W W W W W W W W W W W W W W W W W W W W W W W W 20 20 20 20 20 20 20 20 
10 10 10 10 10 10 10 10 10 10 10 10 10 10 10 10 13 13 13 13 13 13 13 13 13 13 13 13 15 15 15 15 15 15 15 15 15 15 15 15 
10 10 10 10 10 10 10 10 10 10 10 10 10 10 10 10 13 13 13 13 13 13 13 13 13 13 13 13 15 15 15 15 15 15 15 15 15 15 15 15 
10 10 10 10 10 10 10 10 10 10 10 10 10 10 10 10 13 13 13 13 13 13 13 13 13 13 13 13 15 15 15 15 15 15 15 15 15 15 15 15 
10 10 10 10 10 10 10 10 10 10 10 10 10 10 10 10 13 13 13 13 13 13 13 13 13 13 13 13 15 15 15 15 15 15 15 15 15 15 15 15 
9 9 9 9 8 8 8 8 12 12 12 12 12 12 12 12 2 2 2 2 2 2 2 2 2 2 2 2 15 15 15 15 15 15 15 15 15 15 15 15 
9 9 9 9 8 8 8 8 12 12 12 12 12 12 12 12 2 2 2 2 2 2 2 2 2 2 2 2 15 15 15 15 15 15 15 15 15 15 15 15 
9 9 9 9 8 8 8 8 12 12 12 12 12 12 12 12 2 2 2 2 2 2 2 2 2 2 2 2 15 15 15 15 15 15 15 15 15 15 15 15 
9 9 9 9 8 8 8 8 12 12 12 12 12 12 12 12 2 2 2 2 2 2 2 2 2 2 2 2 15 15 15 15 15 15 15 15 15 15 15 15 
5 5 5 5 5 5 5 5 7 7 7 7 1 1 1 1 14 14 14 14 14 14 14 14 14 14 14 14 15 15 15 15 15 15 15 15 15 15 15 15 
5 5 5 5 5 5 5 5 7 7 7 7 1 1 1 1 14 14 14 14 14 14 14 14 14 14 14 14 15 15 15 15 15 15 15 15 15 15 15 15 
5 5 5 5 5 5 5 5 6 6 6 6 1 1 1 1 18 18 18 18 18 18 18 18 18 18 18 18 18 18 18 18 18 18 16 16 16 16 16 16 
5 5 5 5 5 5 5 5 6 6 6 6 1 1 1 1 18 18 18 18 18 18 18 18 18 18 18 18 18 18 18 18 18 18 16 16 16 16 16 16 
5 5 5 5 5 5 5 5 11 11 11 11 11 11 11 11 17 17 17 17 17 17 17 17 17 17 17 17 17 17 17 17 17 17 17 17 17 17 17 17 
5 5 5 5 5 5 5 5 11 11 11 11 11 11 11 11 17 17 17 17 17 17 17 17 17 17 17 17 17 17 17 17 17 17 17 17 17 17 17 17 
5 5 5 5 5 5 5 5 11 11 11 11 11 11 11 11 17 17 17 17 17 17 17 17 17 17 17 17 17 17 17 17 17 17 17 17 17 17 17 17 
A 5 5 5 5 5 5 5 11 11 11 11 11 11 11 11 17 17 17 17 17 17 17 17 17 17 17 17 17 17 17 17 17 17 17 17 17 17 17 17 
